0,2;1,2;1,2;1,2;1,2;1,2;1,2;1,2;1,2;1,2;1,2;1,2;1,2;1,2;1,2;1,2;1,2;1,2;1,2;2,2
0,3;1,3;1,3;1,3;1,3;1,3;1,3;1,3;1,3;1,3;1,3;1,3;1,3;1,3;1,3;1,3;1,3;1,3;1,3;2,3
0,0;0,0;0,0;0,0;0,0;0,0;0,0;0,0;3,5;4,5;4,5;5,5;0,0;0,0;0,0;0,0;0,0;0,0;0,0;0,0
0,0;0,0;0,0;0,0;0,0;0,0;0,0;0,0;3,5;4,5;4,5;5,5;0,0;0,0;0,0;0,0;0,0;0,0;0,0;0,0
0,0;0,0;0,0;0,0;0,0;0,0;0,0;0,0;3,5;4,5;4,5;5,5;0,0;0,0;0,0;0,0;0,0;0,0;0,0;0,0
0,0;0,0;0,0;0,0;0,0;0,0;0,0;0,0;3,5;4,5;4,5;5,5;0,0;0,0;0,0;0,0;0,0;0,0;0,0;0,0
0,0;0,0;0,0;0,0;0,0;0,0;0,0;0,0;3,5;4,5;4,5;5,5;0,0;0,0;0,0;0,0;0,0;0,0;0,0;0,0
0,0;0,0;0,0;0,0;0,0;0,0;0,0;0,0;3,5;4,5;4,5;5,5;0,0;0,0;0,0;0,0;0,0;0,0;0,0;0,0
0,0;0,0;0,0;0,0;0,0;0,0;0,0;0,0;3,5;4,5;4,5;5,5;0,0;0,0;0,0;0,0;0,0;0,0;0,0;0,0
0,0;0,0;0,0;0,0;0,0;0,0;0,0;0,0;3,5;4,5;4,5;5,5;0,0;0,0;0,0;0,0;0,0;0,0;0,0;0,0
0,0;0,0;0,0;0,0;0,0;0,0;0,0;0,0;3,5;4,5;4,5;5,5;0,0;0,0;0,0;0,0;0,0;0,0;0,0;0,0
0,0;0,0;0,0;0,0;0,0;0,0;0,0;0,0;3,5;4,5;4,5;5,5;0,0;0,0;0,0;0,0;0,0;0,0;0,0;0,0
0,0;0,0;0,0;0,0;0,0;0,0;0,0;0,0;3,5;4,5;4,5;5,5;0,0;0,0;0,0;0,0;0,0;0,0;0,0;0,0
0,0;0,0;0,0;0,0;0,0;0,0;0,0;0,0;3,5;4,5;4,5;5,5;0,0;0,0;0,0;0,0;0,0;0,0;0,0;0,0
0,0;0,0;0,0;0,0;0,0;0,0;0,0;0,0;3,5;4,5;4,5;5,5;0,0;0,0;0,0;0,0;0,0;0,0;0,0;0,0
0,0;0,0;0,0;0,0;0,0;0,0;0,0;0,0;3,5;4,5;4,5;5,5;0,0;0,0;0,0;0,0;0,0;0,0;0,0;0,0
0,0;0,0;0,0;0,0;0,0;0,0;0,0;0,0;3,5;4,5;4,5;5,5;0,0;0,0;0,0;0,0;0,0;0,0;0,0;0,0
0,0;0,0;0,0;0,0;0,0;0,0;0,0;0,0;3,5;4,5;4,5;5,5;0,0;0,0;0,0;0,0;0,0;0,0;0,0;0,0
0,0;0,0;0,0;0,0;0,0;0,0;0,0;0,0;3,5;4,5;4,5;5,5;0,0;0,0;0,0;0,0;0,0;0,0;0,0;0,0
0,0;0,0;0,0;0,0;0,0;0,0;0,0;0,0;3,5;4,5;4,5;5,5;0,0;0,0;0,0;0,0;0,0;0,0;0,0;0,0