+-+-+-+-+-+-+-+-+-+-+-+-+-+-+-+-+-+-+-+-+-+-+-+-+-+
 # # # # # #|   |       |     |       |       |   |
+-+-+-+-+-+ +-+ + +-+-+ + +-+ + +-+ + + +-+-+ + + +
|# # #|    #|   | |     | |   | | | | |   |     | |
+ + + +-+-+ + +-+ + +-+-+ + +-+ + + + +-+-+ +-+-+ +
|#| |#|# # #|   | | |   | | |   |   |   |   |     |
+ +-+ + +-+-+-+ + + +-+ + + + +-+-+-+-+-+ +-+ +-+-+
|#|# #|# #|   | | |   | | | | |           |   |   |
+ + +-+ + +-+ + + +-+ + + + + + + +-+-+-+-+ +-+-+ +
|#|# #| |#|   | | |   | | |   | | |   |           |
+ +-+ +-+ + +-+ +-+ +-+ + +-+-+ + + +-+ +-+ +-+-+-+
|# #|# # #|   |         | |     | |     | | |   | |
+-+ +-+-+-+-+ +-+-+ +-+ + + +-+-+ +-+-+-+ + + + + +
|  # # #    | |   |   |   |   |   |   |   |   | | |
+ +-+-+ +-+ + + + +-+ +-+-+-+ + +-+ + + +-+-+ + + +
| | |  # #| |   | |   |       | |   | |       |   |
+ + + +-+ + + +-+ + +-+-+-+-+-+ + + + +-+-+-+-+-+-+
| | | |# #| | | |       |     | | | |       |     |
+ + + + +-+ + + +-+ +-+ + +-+ + + +-+-+-+-+ + +-+ +
|   | |# #|   |   | |   |   | |   |     |       | |
+-+-+ +-+ +-+-+-+ +-+ +-+-+-+ +-+-+ +-+ + +-+ + +-+
|# #|   |#|     |     |     | |   |   | |   | |   |
+ + +-+-+ + +-+ +-+ +-+-+-+ + +-+ +-+-+ +-+ + +-+ +
|#|# #|# #| |   |   |           | |         |   | |
+ +-+ + +-+ + +-+ +-+ +-+-+-+ + + + +-+-+-+-+ + +-+
|#|# #|#| | |     |     |     |   | |   |     |   |
+ + +-+ + + +-+-+-+ +-+-+ + +-+-+-+ +-+ + +-+-+-+ +
|#|# # #|   |# #  | |   | | |     |     |   |# #| |
+ +-+-+-+-+-+ + +-+ + + + +-+ +-+ + +-+-+-+-+ + + +
|#|# # #|   |#|#|   | | | |   |   |     |# # #|#  |
+ + +-+ + + + + + +-+-+ + + +-+ +-+-+-+-+ +-+-+ +-+
|# #|# #| | |#|#|# # #| |   |   |# # # # #| |# #  |
+-+-+ + + + + + + +-+ + +-+-+ +-+ +-+-+-+-+ + +-+-+
|   |#| | | |#|# #|# #| |   | |# #|   |   | |#|# #|
+ + + + + + + +-+ + +-+ + + + + +-+ + + + + + + + +
| | |#| | | |# #| |# #| | |   |#|   |   |   |# #|#|
+ +-+ + +-+ +-+ +-+-+ + +-+-+-+ + +-+ +-+-+ +-+-+ +
| |  #|   | | |#|   |#|     |# #|   |     | |# # #|
+ + + +-+ + + + + + + +-+ + + +-+-+ +-+-+ +-+ +-+-+
|   |# #|   |# #| |  #    | |#|     |       |# #| |
+-+-+-+ +-+-+ +-+ +-+ +-+-+ + + +-+-+-+-+ + + + + +
|     |# # # #|   |# #|     |#|     |     |   |#| |
+ +-+ +-+-+-+-+ +-+ +-+-+-+-+ + +-+ + +-+-+-+-+ + +
|   |   |       |# #|# # # #|#| |   |         |# #|
+-+ +-+ + +-+-+-+ +-+ +-+-+ + + + +-+-+-+-+-+ +-+ +
|     | | |# # # #|# #|   |# #| |   |     |   |  #|
+ + + +-+ + +-+-+-+ +-+ + +-+-+-+-+ + +-+ + +-+-+ +
| | |     |#|# # # #| | |   |   | | |   |   |   |#|
+ +-+-+-+-+ + +-+-+ + + + +-+ + + + +-+ +-+-+ + + +
|         |# #|     |   |     |     |   |     |  # 
+-+-+-+-+-+-+-+-+-+-+-+-+-+-+-+-+-+-+-+-+-+-+-+-+-+
